TORTELL PASSAPARAULA

A: On et vas fotre un bitxo tant coent que et sortia cera de les orelles, tot i els avisos previs del cambrer - ALACANT
B: enemic total gastron√≤mic contra el que lluites aferrissadament fent proselitisme de la teva causa a les nostres filles. BLEDES 
C: Nom pel que et coneix la Bettio - CROISSANT ü•êC: Illes de les que vas ser deportat per un assumpte fosc que feia pudor. Can√†ries
D: El sobrenom que m√©s t'escau - DAT PEL CUL
E: Disfressa amb la que et vas presentar al carnaval de Solsona, on en comptes de disfresses s‚Äôutilitzen bates de colors. EX√àRCIT ROIG
F: Quina muntanya berguedana vam pujar 5 persones dues vegades amb un dorsal a l‚Äôesquena el dia de cap d‚Äôany? FIGUERASSA
G:G: Lloc on vas estar apunt d'ingressar per fer un 'grafitti' (tipus Diana i no de Gal-les) a la fa√ßana d'un conegut supermercat de Berga.
GARJOLA
H: Nom del fil√≤sof que va dir (m√©s o menys) el seg√ºent: No podem rebre dues vegades la mateixa sodomia per part de l'√íscar. Quan hi torna, ni la seva tranca ni el nostre cul s√≥n els mateixos. - HER√ÄCLIT
I: Organitzaci√≥ internacionalista que, gr√†cies a tu, √©s el gra al cul de la CUP. - √çTACA
J: Autor de la can√ß√≥ exitosament coreografiada per cap d'any, a casa vostra, i que de manera infame vas fer p√∫blica. Pista: "... √©s la teva forma de ser..." - JOSEP MARIA CANTIMPLORA 
K: Nom d'una de les poques rep√∫bliques exsovi√®tiques que no has visitat. - KAZAKHSTAN
L:L : Estat en qu√® et van dur a l'hospital despr√©s d'una nit de 'juerga' amb els amics quan eres un preadolescent. LAMENTABLE
LL: el teu sobrenom quan pedales per √†frica (El Llantes)
M: El nostre primer viatge..... i on et vas banyar al mar amb les claus del cotxe a la butxaca del banyador.....qui ho havia de dir que llavors no el podr√≠em obrir!!!! ‚Äì MALLORCA
N:
NY: El sobrenom amb el que et coneixen al Xino Xano (Nyanyo)
O:okupa, la casa que vem marxar amb el cotxe en marxa quan uns ‚Äúpocs amics‚Äùens perseguien
P: On vem provar de dormir fent-nos passar per peregrins del cam√≠ de sant Jaume - PAMPLONA
Q: La primera via llarga que vas haver d arrossegar l Eva. (Queraltina)
R:Rota, l‚Äôamic que vem fer quan vem anar a buscar samarretes per vendre i pagar la multa dels ‚Äúgraffitis‚Äù
S: nom de l'entrentrenament infernal fet a Pedret i del qual et vas escollonar, que constava en 10 repeticions x400 mts. (S√®ries)
T: sobrenom pol√≠tic (trotskar) 
U:
V: L√≠quid div√≠ que no pot ser tot degustat en una sola nit. - VI 
W:
X:nom d la via, on en el 3er llarg et va caure un peu d gat‚Ä¶.Xibalb√†
Y:
Z: Personeta a la que Li has ficat mes mandarines dintre la roba, i a la que vash traumar per que es pensaba que ten√≠a bonys per tot el cos...Com t'agrada Fer bromas a tothom.... ZULEMA